VVVVVVVVVVVVVVVVVVVVVVVVVVVVVVVVVVVVVVVVVVVVVVVVVVVVVVVVVVVVVVVV
VVVVVVVVVVVVVVVVVVVVVVVVVVVVVVVVVVVVVVVVVVVVVVVVVVVVVVVVVVVVVVVV
VVVVVVVVVVVVVVVVVVVVVVVVVVVVVVVVVVVVVVVVVVVVVVVVVVVVVVVVVVVVVVVV
XXXXXXXXXXXXXXXXXXXXXXXXXXXXXXXVVVVVVVVVVVVVVVVVVVVVVVVVVVVVVVVV
X/////////////////////////////XVVVVVVVVVVVVVVVVVVVVVVVVVVVVVVVVV
X/////////////////////////////XVVVVVVVVVVVVVVVVVVVVVVVVVVVVVVVVV
X/////////////////////////////XVVVVVVVVVVVVVVVVVVVVVVVVVVVVVVVVV
X/////////////////////////////XVVVVVVVVVVVVVVVVVVVVVVVVVVVVVVVVV
X/////////////////////////////XVVVVVVVVVVVVVVVVVVVVVVVVVVVVVVVVV
X/////////////////////////////XVVVVVVVVVVVVVVVVVVVVVVVVVVVVVVVVV
//////////////////////////////XVVVVVVVVVVVVVVVVVVVVVVVVVVVVVVVVV
X/////////////////////////////XVVVVVVVVVVVVVVVVVVVVVVVVVVVVVVVVV
X/////////////////////////////XVVVVVVVVVVVVVVVVVVVVVVVVVVVVVVVVV
X/////////////////////////////XVVVVVVVVVVVVVVVVVVVVVVVVVVVVVVVVV
X/////////////////////////////XVVVVVVVVVVVVVVVVVVVVVVVVVVVVVVVVV
X/////////////////////////////XVVVVVVVVVVVVVVVVVVVVVVVVVVVVVVVVV
X/////////////////////////////XVVVVVVVVVVVVVVVVVVVVVVVVVVVVVVVVV
X/////////////////////////////XVVVVVVVVVVVVVVVVVVVVVVVVVVVVVVVVV
XXXXXXXXXXXXXXXXXXXXXXXXXXXXXXXVVVVVVVVVVVVVVVVVVVVVVVVVVVVVVVVV
VVVVVVVVVVVVVVVVVVVVVVVVVVVVVVVVVVVVVVVVVVVVVVVVVVVVVVVVVVVVVVVV
VVVVVVVVVVVVVVVVVVVVVVVVVVVVVVVVVVVVVVVVVVVVVVVVVVVVVVVVVVVVVVVV
VVVVVVVVVVVVVVVVVVVVVVVVVVVVVVVVVVVVVVVVVVVVVVVVVVVVVVVVVVVVVVVV
VVVVVVVVVVVVVVVVVVVVVVVVVVVVVVVVVVVVVVVVVVVVVVVVVVVVVVVVVVVVVVVV
VVVVVVVVVVVVVVVVVVVVVVVVVVVVVVVVVVVVVVVVVVVVVVVVVVVVVVVVVVVVVVVV