VVVVVVVVVVVVVVVVVVVVVVVVVVVVVVVVVVVVVVVVVVVVVVVVVVVVVVVVVVVVVVVV
VVVVVVVVVVVVVVVVVVVVVVVVVVVVVVVVVVVVVVVVVVVVVVVVVVVVVVVVVVVVVVVV
VVVVVVVVVVVVVVVVVVVVVVVVVVVVVVVVVVVVVVVVVVVVVVVVVVVVVVVVVVVVVVVV
VVVVVVVVVVVVVVVVVVVVVVVVVVVVVVVVVVVVVVVVVVVVVVVVVVVVVVVVVVVVVVVV
VVVVVVVVVVVVVVVVVVVVVVVVVVVVVVVVVVVVVVVVVVVVVVVVVVVVVVVVVVVVVVVV
VVVVVVVVVVVVVVVVVVVVVVVVVVVVVVVVVVVVVVVVVVVVVVVVVVVVVVVVVVVVVVVV
VVVVVVVVVVVVVVVVVVVVVVVVVVVVVVVVVVVVVVVVVXXXXXXXXXXXXXXXXXXXXXXX
VVVVVVVVVVVVVVVVVVVVVVVVVVVVVVVVVVVVVVVVVX/////////////////////X
VVVVVVVVVVVVVVVVVVVVVVVVVVVVVVVVVVVVVVVVVX/////////////////////X
VVVVVVVVVVVVVVVVVVVVVVVVVVVVVVVVVVVVVVVVVX/////////////////////X
VVVVVVVVVVVVVVVVVVVVVVVVVVVVVVVVVVVVVVVVVX/////////////////////X
VVVVVVVVVVVVVVVVVVVVVVVVVVVVVVVVVVVVVVVVVX//////////////////////
VVVVVVVVVVVVVVVVVVVVVVVVVVVVVVVVVVVVVVVVVX/////////////////////X
VVVVVVVVVVVVVVVVVVVVVVVVVVVVVVVVVVVVVVVVVX/////////////////////X
VVVVVVVVVVVVVVVVVVVVVVVVVVVVVVVVVVVVVVVVVX/////////////////////X
VVVVVVVVVVVVVVVVVVVVVVVVVVVVVVVVVVVVVVVVVX/////////////////////X
VVVVVVVVVVVVVVVVVVVVVVVVVVVVVVVVVVVVVVVVVXXXXXXXXXXXXXXXXXXXXXXX
VVVVVVVVVVVVVVVVVVVVVVVVVVVVVVVVVVVVVVVVVVVVVVVVVVVVVVVVVVVVVVVV
VVVVVVVVVVVVVVVVVVVVVVVVVVVVVVVVVVVVVVVVVVVVVVVVVVVVVVVVVVVVVVVV
VVVVVVVVVVVVVVVVVVVVVVVVVVVVVVVVVVVVVVVVVVVVVVVVVVVVVVVVVVVVVVVV
VVVVVVVVVVVVVVVVVVVVVVVVVVVVVVVVVVVVVVVVVVVVVVVVVVVVVVVVVVVVVVVV
VVVVVVVVVVVVVVVVVVVVVVVVVVVVVVVVVVVVVVVVVVVVVVVVVVVVVVVVVVVVVVVV
VVVVVVVVVVVVVVVVVVVVVVVVVVVVVVVVVVVVVVVVVVVVVVVVVVVVVVVVVVVVVVVV
VVVVVVVVVVVVVVVVVVVVVVVVVVVVVVVVVVVVVVVVVVVVVVVVVVVVVVVVVVVVVVVV