XXXXXXXXXXXXXXXXXXXXXXXXXXXXXXXXXXXXXXXXXXXXXXXXXXXXXXXXXXXXXXXX
X##############################XX##############################X
X##############################XX##############################X
X##############################################################X
X##############################XX##############################X
X##############################XX##############################X
X##############################XX##############################X
X##############################XX##############################X
X##############################XX##############################X
X##############################XX##############################X
X###############XX#############XX##############################X
X###############XX#############XX##########//##################X
X//////////////////////////////XX//////////////////////////////X
X//////////////////////////////XX//////////////////////////////X
X//////////////////////////////////////////////////////////////X
X//////////////////////////////////////////////////////////////X
X//////////////////////////////////////////////////////////////X
X//////////////////////////////////////////////////////////////X
X//////////////////////////////////////////////////////////////X
X//////////////////////////////////////////////////////////////X
X//////////////////////////////XX//////////////////////////////X
X//////////////////////////////XX//////////////////////////////X
X//////////////////////////////XX//////////////////////////////X
XXXXXXXXXXXX//XXXXXXXXXXXXXXXXXXXXXXXXXXXXXXXXXXXXXXXXXXXXXXXXXX