XXXXXXXXXXXXXXXXXXXXXXXXXXXXXXXXX//XXXXXXXXXXXXXXXXXXXXXXXXXXXXX
X##############################XX//############################X
X##############################XX//############################X
X################################//############################X
X################################//############################X
X#######################////////////////////###################X
X#######################////////////////////###################X
X#######################////////////////////###################X
X##############################XX#########//###################X
X##############################XX#########//###################X
X##############################XX#########//###################X
X##############################XX#########//###################X
X##############################XX//////////////////////////////X
X##############################XX//////////////////////////////X
X##############################XX//////////////////////////////X
X##############################XX//////////////////////////////X
X##############################XX//////////////////////////////X
X//////////////////////////////XX//////////////////////////////X
X//////////////////////////////XX//////////////////////////////X
X//////////////////////////////XX/////////XXXXXX//XXXXXX///////X
X//////////////////////////////XX/////////XXXXXXXXXXXXXX///////X
X//////////////////////////////XX/////////XXXXXXXXXXXXXX///////X
X//////////////////////////////XX/////////XXXXXXXXXXXXXX///////X
XXXXXXXXXXXXXXXXXXXXXXXXXXXXXXXXXXXXXXXXXXXXXXXXXXXXXXXXXXXXXXXX