XXXXXXXXXXXXXXXXXXXXXXXXXXXXXXXXXXXXXXXXXXXXXXXXXXXXXXXXXXXXXXXX
X##############################XX##############################X
X##############~~##############XX##############################X
X###########~~~~~~~~~##########################################X
X########~~~~~~~~~~~###########XX##############################X
X######~~~~~~~~~~~~~~~#########XX##############################X
X########~~~~~~~~~~~###########XX########XXXXXXXXXXXXXX########X
X###########~~~~~~~~~~~########XX########XXXXXX++XXXXXX########X
X##############~~~~############XX########XXXX++++++XXXX########X
X##############################XX########XXXXXX++XXXXXX########X
X###############XX#############XX########XXXXXXXXXXXXXX########X
X###############XX#############XX########XXXXXX//XXXXXX########X
X//////////////////////////////XX//////////////////////////////X
X//////////////////////////////XX//////////////////////////////X
X//////////////////////////////////////////////////////////////X
X//////////////////////////////////////////////////////////////X
X//////////////////////////////////////////////////////////////X
X//////////////////////////////////////////////////////////////X
X//////////////////////////////////////////////////////////////X
X//////////////////////////////////////////////////////////////X
X//////////////////////////////XX//////////////////////////////X
X//////////////////////////////XX//////////////////////////////X
X//////////////////////////////XX//////////////////////////////X
XXXXXXXXXXXX//XXXXXXXXXXXXXXXXXXXXXXXXXXXXXXXXXXXXXXXXXXXXXXXXXX